2 1
#######
#.#...#
#.##.##
#.....#
#.#..$#
#######
