2 1
############
#.#...$....#
#.##.##....#
#.....#..#.#
#.#......#.#
############
